Wiki Templates:
 {{non-canon}}
 {{speculation}}
 {{manual}}
 


public static final int WALL_TILE = 0;
public static final int FLOOR_TILE = 1;
public static final int GOAL_TILE = 2;
public static final int TELE_TILE = 3;
public static final int PAD_TILE = 4;
public static final int BIN_TILE = 5;
public static final int SHOCK_TILE = 6;


Savanna:
000000000000000000000000000000
022221111005111111500111122220
022221111004111111400111122220
022221111111111111111111122220
022221111111111111111111122220
011111111111111111111111111110
011111111111111111111111111110
011111111001111111100111111110
011111111003111111300111111110
000111100000011110000001111000
000111100000011110000001111000
054111113001111111100311111450
011111111001111111100111111110
011111111111111111111111111110
011111111111111111111111111110
011111111111111111111111111110
011111111111111111111111111110
011111111001111111100111111110
054111113001111111100311111450
000111100000011110000001111000
000111100000011110000001111000
011111111003111111300111111110
011111111001111111100111111110
011111111111111111111111111110
011111111111111111111111111110
022221111111111111111111122220
022221111111111111111111122220
022221111004111111400111122220
022221111005111111500111122220
000000000000000000000000000000