Wiki Templates:
 {{non-canon}}
 {{speculation}}
 {{manual}}
 


public static final int WALL_TILE = 0;
public static final int FLOOR_TILE = 1;
public static final int GOAL_TILE = 2;
public static final int TELE_TILE = 3;
public static final int PAD_TILE = 4;
public static final int BIN_TILE = 5;
public static final int SHOCK_TILE = 6;

Gadel Spyre:
000000000000000000000000000000
022221115003111111100511122220
022221114001111111100411122220
022221111001111111111111122220
022221111001111111111111122220
011111111001111111111111111110
011111111001111111111111111110
011111111001111111100111111110
011111111003111111100111111450
000111100000011110000001111000
000111100000011110000001111000
000111100003111111500001111000
000111100001111111400001111000
000111161111111111111161111000
000111161111111111111161113000
000311161111111111111161111000
000111161111111111111161111000
000111100004111111100001111000
000111100005111111300001111000
000111100000011110000001111000
000111100000011110000001111000
054111111001111111300111111110
011111111001111111100111111110
011111111111111111100111111110
011111111111111111100111111110
022221111111111111100111122220
022221111111111111100111122220
022221111001111111100411122220
022221145001111111300511122220
000000000000000000000000000000